Pet is Dog Boolen,Pet is Cat Boolen,YEAR,NEIGHBOURHOOD,NEIGHBOURHOOD_ID,Pet Type,Number of Pets
0,27,2020,Sakaw,6670,Cat,27
2,0,2018,Walker,6662,Dog,2
0,82,2020,Strathcona,5480,Cat,82
219,0,2019,Grovenor,3210,Dog,219
0,2,2019,River's Edge,4469,Cat,2
0,11,2019,Richford,5451,Cat,11
29,0,2020,Evergreen,2270,Dog,29
0,2,2020,Albany,3460,Cat,2
0,22,2020,Athlone,3010,Cat,22
3,0,2020,Edmonton South West,8888,Dog,3
2,0,2018,Ermineskin,5180,Dog,2
41,0,2020,Britannia Youngstown,4060,Dog,41
0,40,2020,Queen Mary Park,1180,Cat,40
73,0,2019,Clareview Town Centre,2145,Dog,73
91,0,2019,Spruce Avenue,1230,Dog,91
0,67,2019,Blackmud Creek,5453,Cat,67
307,0,2019,Calder,3070,Dog,307
0,196,2019,Inglewood,3240,Cat,196
75,0,2020,Wild Rose,6790,Dog,75
0,23,2020,Haddow,5610,Cat,23
27,0,2019,Graydon Hill,5468,Dog,27
0,27,2019,Carter Crest,5130,Cat,27
0,104,2019,Bannerman,2030,Cat,104
0,1,2018,Abbottsfield,2010,Cat,1
0,33,2020,Wellington,3430,Cat,33
0,73,2019,Oleskiw,4360,Cat,73
0,3,2020,Abbottsfield,2010,Cat,3
109,0,2019,Blackburne,5590,Dog,109
18,0,2020,Bergman,2090,Dog,18
0,156,2019,Britannia Youngstown,4060,Cat,156
0,49,2020,Ottewell,6550,Cat,49
0,17,2020,Meyonohk,6470,Cat,17
22,0,2020,Glengarry,2290,Dog,22
0,2,2020,Heritage Valley Town Centre Area,5464,Cat,2
344,0,2019,King Edward Park,6360,Dog,344
25,0,2020,Crystallina Nera West,2463,Dog,25
0,1,2018,Griesbach,3111,Cat,1
224,0,2019,Caernarvon,3060,Dog,224
38,0,2020,Belgravia,5040,Dog,38
16,0,2020,Windsor Park,5580,Dog,16
0,36,2020,Meyokumin,6460,Cat,36
4,0,2019,River Valley Fort Edmonton,5401,Dog,4
83,0,2019,Skyrattler,5460,Dog,83
0,15,2020,Hairsine,2320,Cat,15
0,9,2020,Keheewin,5250,Cat,9
0,28,2020,Forest Heights,6230,Cat,28
0,4,2020,Mill Woods Town Centre,6520,Cat,4
0,111,2019,York,2720,Cat,111
29,0,2020,Rundle Heights,2660,Dog,29
0,1,2016,Glenwood,4180,Cat,1
163,0,2019,Gariepy,4160,Dog,163
0,138,2019,Kensington,3250,Cat,138
0,106,2019,Wild Rose,6790,Cat,106
34,0,2020,Weinlos,6770,Dog,34
14,0,2020,Richford,5451,Dog,14
0,14,2020,McLeod,2530,Cat,14
1,0,2018,King Edward Park,6360,Dog,1
37,0,2020,Maple Ridge,6410,Dog,37
427,0,2019,Westmount,3440,Dog,427
0,98,2019,Lorelei,3280,Cat,98
4,0,2019,Kennedale Industrial,2380,Dog,4
194,0,2019,Avonmore,6020,Dog,194
59,0,2020,Larkspur,6390,Dog,59
65,0,2019,Rural North East South Sturgeon,2690,Dog,65
21,0,2020,Tipaskan,6750,Dog,21
55,0,2019,Blue Quill Estates,5070,Dog,55
0,22,2020,Homesteader,2350,Cat,22
0,2,2019,Rural North East Horse Hill,2670,Cat,2
0,60,2019,Argyll,6010,Cat,60
104,0,2019,McQueen,3300,Dog,104
38,0,2020,Daly Grove,6150,Dog,38
0,27,2020,Britannia Youngstown,4060,Cat,27
0,30,2020,Parkdale,1160,Cat,30
0,38,2020,Dunluce,3180,Cat,38
0,70,2019,Schonsee,2700,Cat,70
0,98,2019,North Glenora,3310,Cat,98
145,0,2019,Donsdale,4120,Dog,145
205,0,2019,Downtown,1090,Dog,205
0,16,2020,Patricia Heights,4390,Cat,16
359,0,2019,Oliver,1150,Dog,359
0,106,2019,Minchau,6530,Cat,106
0,27,2020,Daly Grove,6150,Cat,27
0,2,2019,Lewis Farms Industrial,4485,Cat,2
0,119,2019,Westview Village,4620,Cat,119
106,0,2020,Ottewell,6550,Dog,106
366,0,2019,Ormsby Place,4380,Dog,366
48,0,2020,Greenview,6280,Dog,48
153,0,2019,Dechene,4110,Dog,153
111,0,2019,Keswick Area,5576,Dog,111
226,0,2019,Britannia Youngstown,4060,Dog,226
1,0,2018,Wellington,3430,Dog,1
208,0,2019,Oleskiw,4360,Dog,208
7,0,2019,Rural North East Horse Hill,2670,Dog,7
0,1,2018,Kernohan,2390,Cat,1
27,0,2020,Brookside,5090,Dog,27
0,21,2020,Avonmore,6020,Cat,21
90,0,2019,Carter Crest,5130,Dog,90
51,0,2020,Kernohan,2390,Dog,51
0,119,2019,Jamieson Place,4220,Cat,119
300,0,2019,La Perle,4240,Dog,300
30,0,2020,Brander Gardens,5080,Dog,30
18,0,2019,Decoteau,6663,Dog,18
51,0,2020,Lauderdale,3260,Dog,51
1,0,2018,Baturyn,3030,Dog,1
0,73,2019,Weinlos,6770,Cat,73
1,0,2018,Downtown,1090,Dog,1
0,5,2020,Henderson Estates,5230,Cat,5
232,0,2019,Montrose,2550,Dog,232
234,0,2019,Evansdale,2260,Dog,234
0,31,2020,Aldergrove,4020,Cat,31
0,19,2020,Boyle Street,1020,Cat,19
0,55,2019,Bearspaw,5030,Cat,55
174,0,2019,Minchau,6530,Dog,174
181,0,2019,Kenilworth,6350,Dog,181
56,0,2020,Bonnie Doon,6040,Dog,56
19,0,2020,Argyll,6010,Dog,19
66,0,2020,La Perle,4240,Dog,66
2,0,2017,Ozerna,2600,Dog,2
223,0,2019,Bannerman,2030,Dog,223
0,22,2020,Kirkness,2430,Cat,22
0,22,2020,Eastwood,1100,Cat,22
0,7,2019,Mill Woods Town Centre,6520,Cat,7
0,28,2020,Queen Alexandra,5330,Cat,28
185,0,2019,Kildare,2400,Dog,185
43,0,2020,Evansdale,2260,Dog,43
75,0,2020,Terwillegar Towne,5640,Dog,75
23,0,2020,Jasper Park,4230,Dog,23
6,0,2020,Hays Ridge Area,5465,Dog,6
0,64,2019,Lee Ridge,6400,Cat,64
7,0,2020,The Uplands,4464,Dog,7
236,0,2019,Haddow,5610,Dog,236
0,7,2020,Rideau Park,5360,Cat,7
27,0,2020,Hodgson,5620,Dog,27
0,26,2020,The Orchards At Ellerslie,6216,Cat,26
0,19,2020,Duggan,5160,Cat,19
0,94,2019,Bisset,6030,Cat,94
1,0,2018,Silver Berry,6442,Dog,1
57,0,2020,Kilkenny,2410,Dog,57
102,0,2019,Idylwylde,6320,Dog,102
31,0,2020,Maple,6441,Dog,31
16,0,2020,Sherwood,4500,Dog,16
0,1,2019,Coronet Addition Industrial,6090,Cat,1
0,229,2019,Rutherford,5454,Cat,229
99,0,2019,Sifton Park,2710,Dog,99
62,0,2019,Cromdale,1070,Dog,62
0,18,2020,Grovenor,3210,Cat,18
0,8,2020,Blackburne,5590,Cat,8
0,14,2020,Evansdale,2260,Cat,14
0,15,2020,Michaels Park,6480,Cat,15
0,97,2019,Royal Gardens,5430,Cat,97
232,0,2019,Hillview,6300,Dog,232
0,21,2020,Hazeldean,6290,Cat,21
1,0,2018,Albany,3460,Dog,1
0,17,2020,Granville,4551,Cat,17
352,0,2019,Baturyn,3030,Dog,352
0,3,2019,Quesnell Heights,4420,Cat,3
5,0,2020,Rural North East Horse Hill,2670,Dog,5
0,40,2019,Kameyosek,6340,Cat,40
111,0,2019,Hudson,3480,Dog,111
147,0,2019,Elsinore,3190,Dog,147
0,1,2019,Southeast Industrial,6690,Cat,1
123,0,2019,Jasper Park,4230,Dog,123
35,0,2020,Meyonohk,6470,Dog,35
76,0,2020,Baturyn,3030,Dog,76
0,118,2019,Balwin,2020,Cat,118
0,165,2019,Highlands,2330,Cat,165
0,10,2020,Starling,4474,Cat,10
0,6,2020,Brander Gardens,5080,Cat,6
49,0,2020,The Orchards At Ellerslie,6216,Dog,49
0,4,2019,Cavanagh,5467,Cat,4
1,0,2019,River Valley Highlands,2640,Dog,1
1,0,2019,Glenridding Ravine,5579,Dog,1
0,12,2020,Bisset,6030,Cat,12
31,0,2020,Laurel,6444,Dog,31
75,0,2020,Crawford Plains,6140,Dog,75
0,10,2020,Magrath Heights,5476,Cat,10
199,0,2019,Rosslyn,3390,Dog,199
6,0,2020,Graydon Hill,5468,Dog,6
1,0,2020,Kinokamau Plains Area,4475,Dog,1
1,0,2018,Meyokumin,6460,Dog,1
0,49,2020,King Edward Park,6360,Cat,49
0,20,2020,Carlton,3470,Cat,20
0,1,2019,Alberta Park Industrial,4010,Cat,1
3,0,2019,High Park Industrial,4210,Dog,3
0,64,2019,Richfield,6600,Cat,64
0,20,2020,Belmead,4040,Cat,20
0,50,2019,Rossdale,1220,Cat,50
328,0,2019,Glenora,3200,Dog,328
0,1,2018,Hillview,6300,Cat,1
0,61,2019,Spruce Avenue,1230,Cat,61
86,0,2019,Prince Rupert,1170,Dog,86
127,0,2020,Glastonbury,4720,Dog,127
64,0,2020,Beverly Heights,2100,Dog,64
166,0,2019,Magrath Heights,5476,Dog,166
216,0,2019,Eastwood,1100,Dog,216
0,97,2019,Secord,4487,Cat,97
0,40,2020,Belmont,2070,Cat,40
0,14,2020,Crystallina Nera West,2463,Cat,14
0,108,2019,Callingwood South,4080,Cat,108
3,0,2018,Westmount,3440,Dog,3
0,1,2018,Lee Ridge,6400,Cat,1
0,119,2019,Windermere,5570,Cat,119
44,0,2020,Bannerman,2030,Dog,44
64,0,2020,Aldergrove,4020,Dog,64
211,0,2019,Lynnwood,4280,Dog,211
1,0,2018,Keswick Area,5576,Dog,1
0,73,2019,Steinhauer,5470,Cat,73
444,0,2019,Chappelle Area,5462,Dog,444
0,17,2020,Potter Greens,4710,Cat,17
104,0,2019,Callingwood North,4070,Dog,104
2,0,2020,Winterburn Industrial Area East,4650,Dog,2
162,0,2019,North Glenora,3310,Dog,162
42,0,2020,Ramsay Heights,5340,Dog,42
23,0,2020,Callingwood South,4080,Dog,23
26,0,2020,Mactaggart,5477,Dog,26
0,3,2019,The Uplands,4464,Cat,3
1,0,2018,Blue Quill,5060,Dog,1
0,3,2020,Hawks Ridge,4473,Cat,3
0,42,2019,Sifton Park,2710,Cat,42
0,130,2019,Belvedere,2080,Cat,130
0,4,2020,McQueen,3300,Cat,4
0,31,2020,Lynnwood,4280,Cat,31
229,0,2019,Belvedere,2080,Dog,229
0,17,2019,Grandview Heights,5210,Cat,17
0,4,2020,Donsdale,4120,Cat,4
26,0,2020,Abbottsfield,2010,Dog,26
73,0,2020,King Edward Park,6360,Dog,73
0,16,2020,Westridge,4610,Cat,16
26,0,2020,Wedgewood Heights,4570,Dog,26
0,149,2019,Kirkness,2430,Cat,149
1,0,2019,Davies Industrial West,6170,Dog,1
0,52,2019,Callaghan,5457,Cat,52
114,0,2020,Rutherford,5454,Dog,114
0,51,2020,Chappelle Area,5462,Cat,51
0,9,2019,CPR Irvine,6110,Cat,9
62,0,2019,Baranow,3020,Dog,62
15,0,2020,West Jasper Place,4580,Dog,15
0,91,2019,Meyokumin,6460,Cat,91
207,0,2019,Westview Village,4620,Dog,207
4,0,2018,Hollick-Kenyon,2340,Dog,4
0,14,2020,Clareview Town Centre,2145,Cat,14
39,0,2020,Caernarvon,3060,Dog,39
3,0,2018,Beverly Heights,2100,Dog,3
0,10,2020,Brookside,5090,Cat,10
0,19,2019,Hawks Ridge,4473,Cat,19
0,45,2019,Bergman,2090,Cat,45
0,104,2019,Eastwood,1100,Cat,104
0,8,2020,Paisley,5469,Cat,8
1,0,2019,McIntyre Industrial,6430,Dog,1
0,50,2020,Cumberland,3150,Cat,50
186,0,2019,Crestwood,3140,Dog,186
0,124,2019,Lago Lindo,2450,Cat,124
0,79,2019,Belle Rive,2050,Cat,79
151,0,2019,Crystallina Nera West,2463,Dog,151
0,143,2019,Montrose,2550,Cat,143
0,43,2020,Strathearn,6710,Cat,43
0,8,2020,Bellevue,2060,Cat,8
0,155,2019,Kilkenny,2410,Cat,155
0,3,2019,Aster,6445,Cat,3
0,2,2018,Mayfield,4290,Cat,2
0,82,2019,Gariepy,4160,Cat,82
0,1,2018,Aldergrove,4020,Cat,1
0,27,2020,Greenview,6280,Cat,27
1,0,2018,Duggan,5160,Dog,1
1,0,2020,Wilson Industrial,4640,Dog,1
1,0,2019,McNamara Industrial,4300,Dog,1
124,0,2019,Kameyosek,6340,Dog,124
28,0,2020,Eaux Claires,2241,Dog,28
36,0,2020,Keswick Area,5576,Dog,36
0,31,2019,Dechene,4110,Cat,31
287,0,2019,Griesbach,3111,Dog,287
0,57,2019,Tamarack,6443,Cat,57
0,78,2019,Eaux Claires,2241,Cat,78
0,46,2020,Crawford Plains,6140,Cat,46
190,0,2019,Oxford,3320,Dog,190
0,2,2020,River Valley Laurier,3382,Cat,2
182,0,2019,Maple Ridge,6410,Dog,182
0,3,2018,Gold Bar,6270,Cat,3
98,0,2019,Prince Charles,3350,Dog,98
0,110,2019,Duggan,5160,Cat,110
0,8,2020,Ogilvie Ridge,5300,Cat,8
0,1,2018,Canossa,3080,Cat,1
32,0,2020,Elsinore,3190,Dog,32
0,38,2020,Kiniski Gardens,6370,Cat,38
0,83,2019,Kildare,2400,Cat,83
0,8,2020,Bulyea Heights,5100,Cat,8
373,0,2019,Glastonbury,4720,Dog,373
309,0,2019,Brintnell,2110,Dog,309
58,0,2020,Ellerslie,6211,Dog,58
0,15,2020,Windsor Park,5580,Cat,15
1,0,2016,Glenwood,4180,Dog,1
33,0,2020,Belvedere,2080,Dog,33
48,0,2020,Canossa,3080,Dog,48
0,70,2020,Downtown,1090,Cat,70
225,0,2019,Ellerslie,6211,Dog,225
0,8,2020,Suder Greens,4730,Cat,8
0,104,2019,Allendale,5010,Cat,104
1,0,2018,Satoo,6680,Dog,1
408,0,2019,Dunluce,3180,Dog,408
0,1,2018,Beacon Heights,2040,Cat,1
0,4,2018,Rutherford,5454,Cat,4
51,0,2020,Gold Bar,6270,Dog,51
279,0,2019,Hazeldean,6290,Dog,279
1,0,2018,Pollard Meadows,6580,Dog,1
25,0,2020,Patricia Heights,4390,Dog,25
0,216,2019,King Edward Park,6360,Cat,216
4,0,2019,Edmonton South East,8886,Dog,4
76,0,2020,Parkview,3330,Dog,76
1,0,2018,Lynnwood,4280,Dog,1
0,10,2020,Beaumaris,3040,Cat,10
179,0,2019,Thorncliff,4560,Dog,179
0,1,2019,Youngstown Industrial,4660,Cat,1
0,5,2020,Baranow,3020,Cat,5
144,0,2019,Royal Gardens,5430,Dog,144
320,0,2019,Belmont,2070,Dog,320
34,0,2020,Rapperswill,3370,Dog,34
1,0,2018,Bannerman,2030,Dog,1
0,81,2019,Crystallina Nera West,2463,Cat,81
0,1,2018,Mayliewan,2511,Cat,1
0,67,2020,Summerside,6213,Cat,67
0,16,2019,Ebbers,2251,Cat,16
1,0,2020,Marquis,2671,Dog,1
0,136,2019,Aldergrove,4020,Cat,136
32,0,2020,Tamarack,6443,Dog,32
135,0,2019,Parkallen,5310,Dog,135
1,0,2018,York,2720,Dog,1
0,19,2020,Lendrum Place,5270,Cat,19
0,11,2020,Rhatigan Ridge,5350,Cat,11
1,0,2018,Ormsby Place,4380,Dog,1
36,0,2020,Balwin,2020,Dog,36
0,141,2019,Homesteader,2350,Cat,141
20,0,2020,Hawks Ridge,4473,Dog,20
263,0,2019,Ritchie,6610,Dog,263
339,0,2019,Twin Brooks,5511,Dog,339
56,0,2019,Rideau Park,5360,Dog,56
0,17,2020,Secord,4487,Cat,17
53,0,2020,Jamieson Place,4220,Dog,53
0,1,2018,Meyokumin,6460,Cat,1
0,77,2019,Suder Greens,4730,Cat,77
130,0,2019,High Park,4200,Dog,130
0,56,2019,Elmwood Park,1130,Cat,56
0,31,2019,Rideau Park,5360,Cat,31
0,4,2019,Stillwater,4468,Cat,4
0,113,2019,Lynnwood,4280,Cat,113
0,18,2020,Northmount,2580,Cat,18
445,0,2019,Windermere,5570,Dog,445
17,0,2020,Bellevue,2060,Dog,17
6,0,2019,River's Edge,4469,Dog,6
0,1,2020,Graydon Hill,5468,Cat,1
216,0,2019,Bulyea Heights,5100,Dog,216
0,106,2019,Central McDougall,1030,Cat,106
105,0,2019,McKernan,5290,Dog,105
10,0,2019,Kinokamau Plains Area,4475,Dog,10
2,0,2018,Britannia Youngstown,4060,Dog,2
17,0,2020,Westwood,1250,Dog,17
1,0,2018,Glenwood,4180,Dog,1
107,0,2019,Westwood,1250,Dog,107
0,67,2019,Woodcroft,3450,Cat,67
1,0,2017,Glastonbury,4720,Dog,1
2,0,2018,Oliver,1150,Dog,2
1,0,2018,Jasper Park,4230,Dog,1
0,59,2020,The Hamptons,4461,Cat,59
0,93,2019,Evergreen,2270,Cat,93
133,0,2019,Eaux Claires,2241,Dog,133
0,7,2019,Hays Ridge Area,5465,Cat,7
340,0,2019,Klarvatten,2440,Dog,340
0,122,2019,Pleasantview,5320,Cat,122
0,9,2020,Sifton Park,2710,Cat,9
0,41,2019,Baranow,3020,Cat,41
46,0,2020,Klarvatten,2440,Dog,46
0,44,2020,Kilkenny,2410,Cat,44
0,72,2019,Northmount,2580,Cat,72
176,0,2019,Laurel,6444,Dog,176
166,0,2019,Northmount,2580,Dog,166
0,62,2019,Charlesworth,6661,Cat,62
0,26,2019,Cloverdale,6070,Cat,26
85,0,2020,Ambleside,5505,Dog,85
0,123,2019,Boyle Street,1020,Cat,123
81,0,2019,Falconer Heights,5190,Dog,81
19,0,2020,Lendrum Place,5270,Dog,19
28,0,2020,Kildare,2400,Dog,28
167,0,2019,Suder Greens,4730,Dog,167
0,13,2020,Callingwood North,4070,Cat,13
6,0,2020,Virginia Park,1240,Dog,6
0,109,2019,Elmwood,4140,Cat,109
63,0,2020,Wellington,3430,Dog,63
1,0,2018,Kildare,2400,Dog,1
0,224,2019,Dunluce,3180,Cat,224
85,0,2020,Hollick-Kenyon,2340,Dog,85
0,11,2020,Summerlea,4520,Cat,11
0,20,2020,Fraser,2280,Cat,20
0,1,2018,Ritchie,6610,Cat,1
0,25,2020,Jamieson Place,4220,Cat,25
1,0,2018,Caernarvon,3060,Dog,1
28,0,2020,Lansdowne,5260,Dog,28
9,0,2020,Ogilvie Ridge,5300,Dog,9
0,29,2020,Blue Quill,5060,Cat,29
106,0,2019,West Jasper Place,4580,Dog,106
102,0,2019,Empire Park,5170,Dog,102
0,35,2020,Baturyn,3030,Cat,35
0,4,2020,Argyll,6010,Cat,4
0,102,2019,Maple Ridge,6410,Cat,102
3,0,2019,Southeast Industrial,6690,Dog,3
0,1,2018,Sherbrooke,3410,Cat,1
12,0,2020,Grandview Heights,5210,Dog,12
27,0,2020,Rosenthal,4750,Dog,27
0,15,2020,Jackson Heights,6330,Cat,15
1,0,2020,Papaschase Industrial,6560,Dog,1
0,198,2019,Calder,3070,Cat,198
0,136,2019,McConachie Area,2521,Cat,136
81,0,2020,South Terwillegar,5642,Dog,81
1,0,2018,Capilano,6061,Dog,1
29,0,2020,Charlesworth,6661,Dog,29
21,0,2020,Canon Ridge,2120,Dog,21
0,1,2019,Edmonton South East,8886,Cat,1
0,17,2020,Kenilworth,6350,Cat,17
163,0,2020,Summerside,6213,Dog,163
0,41,2020,Silver Berry,6442,Cat,41
0,10,2020,Chambery,3120,Cat,10
50,0,2020,Hillview,6300,Dog,50
239,0,2019,Kirkness,2430,Dog,239
0,24,2020,West Meadowlark Park,4590,Cat,24
61,0,2020,MacEwan,5452,Dog,61
0,2,2018,Evansdale,2260,Cat,2
21,0,2020,Terrace Heights,6730,Dog,21
0,40,2020,Inglewood,3240,Cat,40
0,9,2020,Tamarack,6443,Cat,9
0,5,2020,Rural North East Horse Hill,2670,Cat,5
271,0,2019,Sakaw,6670,Dog,271
0,44,2019,Windsor Park,5580,Cat,44
0,28,2019,Glenridding Heights,5578,Cat,28
107,0,2019,Bearspaw,5030,Dog,107
523,0,2019,Alberta Avenue,1010,Dog,523
41,0,2020,Minchau,6530,Dog,41
0,107,2019,Lauderdale,3260,Cat,107
1,0,2018,Baranow,3020,Dog,1
14,0,2020,Clareview Town Centre,2145,Dog,14
0,57,2019,Rapperswill,3370,Cat,57
0,83,2019,Idylwylde,6320,Cat,83
169,0,2019,Meyokumin,6460,Dog,169
0,16,2020,Belvedere,2080,Cat,16
37,0,2020,Bulyea Heights,5100,Dog,37
0,16,2020,Glengarry,2290,Cat,16
0,137,2019,Klarvatten,2440,Cat,137
0,494,2019,Oliver,1150,Cat,494
7,0,2020,Prince Rupert,1170,Dog,7
0,4,2019,Mistatim Industrial,4320,Cat,4
1,0,2018,Greenview,6280,Dog,1
39,0,2020,Potter Greens,4710,Dog,39
1,0,2020,Parsons Industrial,6570,Dog,1
2,0,2018,Belmead,4040,Dog,2
0,2,2020,Quesnell Heights,4420,Cat,2
0,11,2020,Webber Greens,4740,Cat,11
0,88,2019,Casselman,2130,Cat,88
1,0,2018,Northmount,2580,Dog,1
147,0,2019,Bergman,2090,Dog,147
2,0,2018,Bulyea Heights,5100,Dog,2
168,0,2019,Pleasantview,5320,Dog,168
193,0,2019,Lauderdale,3260,Dog,193
1,0,2020,Heritage Valley Town Centre Area,5464,Dog,1
33,0,2020,North Glenora,3310,Dog,33
2,0,2018,The Hamptons,4461,Dog,2
0,10,2020,Tawa,6720,Cat,10
1,0,2020,Mill Woods Town Centre,6520,Dog,1
304,0,2019,Strathcona,5480,Dog,304
1,0,2018,Hodgson,5620,Dog,1
2,0,2019,Garside Industrial,4170,Dog,2
0,2,2019,Graydon Hill,5468,Cat,2
231,0,2019,York,2720,Dog,231
170,0,2019,Matt Berry,2500,Dog,170
39,0,2020,Casselman,2130,Dog,39
0,34,2019,Maple,6441,Cat,34
0,53,2020,Lymburn,4270,Cat,53
3,0,2018,Holyrood,6310,Dog,3
88,0,2019,Argyll,6010,Dog,88
33,0,2020,Tweddle Place,6760,Dog,33
118,0,2019,Bellevue,2060,Dog,118
36,0,2020,Mayliewan,2511,Dog,36
0,123,2019,Ambleside,5505,Cat,123
0,28,2020,West Jasper Place,4580,Cat,28
1,0,2018,Casselman,2130,Dog,1
0,1,2020,Rosedale Industrial,6650,Cat,1
0,27,2019,Leger,5630,Cat,27
0,7,2020,Eaux Claires,2241,Cat,7
0,9,2020,Miller,2541,Cat,9
244,0,2019,Balwin,2020,Dog,244
0,23,2020,Lauderdale,3260,Cat,23
112,0,2019,Hodgson,5620,Dog,112
28,0,2020,Webber Greens,4740,Dog,28
0,12,2020,Ozerna,2600,Cat,12
31,0,2020,Blackmud Creek,5453,Dog,31
136,0,2019,Brander Gardens,5080,Dog,136
0,1,2020,Kennedale Industrial,2380,Cat,1
9,0,2019,Mistatim Industrial,4320,Dog,9
15,0,2020,Empire Park,5170,Dog,15
0,1,2018,Lauderdale,3260,Cat,1
0,31,2020,Parkview,3330,Cat,31
171,0,2019,Meyonohk,6470,Dog,171
0,14,2020,Skyrattler,5460,Cat,14
483,0,2019,Ottewell,6550,Dog,483
0,1,2018,Callingwood South,4080,Cat,1
41,0,2020,Lorelei,3280,Dog,41
0,5,2020,Bergman,2090,Cat,5
39,0,2020,Mayfield,4290,Dog,39
0,117,2019,Athlone,3010,Cat,117
37,0,2020,Ermineskin,5180,Dog,37
9,0,2020,Elmwood Park,1130,Dog,9
0,30,2019,Potter Greens,4710,Cat,30
204,0,2019,Lorelei,3280,Dog,204
142,0,2019,Rosenthal,4750,Dog,142
13,0,2019,Marquis,2671,Dog,13
98,0,2019,Boyle Street,1020,Dog,98
23,0,2020,Downtown,1090,Dog,23
0,1,2018,Westview Village,4620,Cat,1
0,6,2020,Maple,6441,Cat,6
0,23,2020,Carlisle,3090,Cat,23
3,0,2019,Wilson Industrial,4640,Dog,3
0,33,2020,Empire Park,5170,Cat,33
24,0,2020,Henderson Estates,5230,Dog,24
0,33,2020,Highlands,2330,Cat,33
0,87,2019,Ramsay Heights,5340,Cat,87
1,0,2016,Charlesworth,6661,Dog,1
52,0,2020,Beacon Heights,2040,Dog,52
30,0,2020,Magrath Heights,5476,Dog,30
0,92,2019,Pollard Meadows,6580,Cat,92
0,18,2020,Caernarvon,3060,Cat,18
40,0,2020,Delton,1080,Dog,40
0,207,2019,Kiniski Gardens,6370,Cat,207
0,35,2019,Magrath Heights,5476,Cat,35
231,0,2019,Athlone,3010,Dog,231
1,0,2019,Bonaventure Industrial,4050,Dog,1
0,24,2020,Newton,2560,Cat,24
107,0,2019,Aspen Gardens,5020,Dog,107
207,0,2019,Duggan,5160,Dog,207
52,0,2020,Carlton,3470,Dog,52
0,7,2020,Carter Crest,5130,Cat,7
0,40,2020,Wild Rose,6790,Cat,40
0,100,2019,Brintnell,2110,Cat,100
2,0,2018,Malmo Plains,5280,Dog,2
120,0,2019,Malmo Plains,5280,Dog,120
0,1,2020,Desrochers Area,5463,Cat,1
0,11,2020,Lansdowne,5260,Cat,11
0,121,2019,Killarney,2420,Cat,121
0,19,2020,Charlesworth,6661,Cat,19
59,0,2020,Secord,4487,Dog,59
0,14,2019,Ogilvie Ridge,5300,Cat,14
0,40,2019,Edgemont,4462,Cat,40
0,1,2018,Lorelei,3280,Cat,1
2,0,2020,University of Alberta Farm,5530,Dog,2
0,7,2020,Jasper Park,4230,Cat,7
213,0,2019,Greenview,6280,Dog,213
35,0,2020,Blue Quill,5060,Dog,35
0,1,2018,Terrace Heights,6730,Cat,1
53,0,2020,Kenilworth,6350,Dog,53
0,90,2019,Walker,6662,Cat,90
444,0,2019,Kiniski Gardens,6370,Dog,444
1,0,2018,Tamarack,6443,Dog,1
0,301,2019,Downtown,1090,Cat,301
20,0,2020,Prince Charles,3350,Dog,20
169,0,2019,Hairsine,2320,Dog,169
17,0,2020,Spruce Avenue,1230,Dog,17
292,0,2019,Fraser,2280,Dog,292
1,0,2018,La Perle,4240,Dog,1
4,0,2019,Davies Industrial East,6160,Dog,4
173,0,2019,Allard,5458,Dog,173
29,0,2019,Virginia Park,1240,Dog,29
26,0,2020,Bisset,6030,Dog,26
19,0,2020,Overlanders,2590,Dog,19
262,0,2019,Bonnie Doon,6040,Dog,262
0,1,2018,Twin Brooks,5511,Cat,1
0,14,2020,Blackmud Creek,5453,Cat,14
0,113,2019,Wellington,3430,Cat,113
247,0,2019,Secord,4487,Dog,247
0,100,2019,Avonmore,6020,Cat,100
6,0,2020,Stillwater,4468,Dog,6
0,22,2020,Brintnell,2110,Cat,22
40,0,2020,York,2720,Dog,40
0,64,2019,Laurier Heights,3270,Cat,64
0,26,2020,Beacon Heights,2040,Cat,26
0,66,2019,Tweddle Place,6760,Cat,66
3,0,2018,Kiniski Gardens,6370,Dog,3
144,0,2019,Canora,4090,Dog,144
46,0,2020,Chambery,3120,Dog,46
0,22,2020,Hillview,6300,Cat,22
261,0,2019,Larkspur,6390,Dog,261
0,55,2020,Westmount,3440,Cat,55
0,11,2020,Rapperswill,3370,Cat,11
0,113,2019,Glenora,3200,Cat,113
45,0,2019,Terra Losa,4540,Dog,45
3,0,2018,Hairsine,2320,Dog,3
73,0,2020,Twin Brooks,5511,Dog,73
0,45,2019,Aspen Gardens,5020,Cat,45
0,23,2020,Ellerslie,6211,Cat,23
29,0,2020,Parkallen,5310,Dog,29
155,0,2019,Ekota,6200,Dog,155
43,0,2020,Dovercourt,3170,Dog,43
0,6,2020,Prince Rupert,1170,Cat,6
3,0,2018,Alberta Avenue,1010,Dog,3
13,0,2019,Heritage Valley Town Centre Area,5464,Dog,13
151,0,2019,Keheewin,5250,Dog,151
20,0,2020,High Park,4200,Dog,20
4,0,2019,Hagmann Estate Industrial,3220,Dog,4
18,0,2020,Keheewin,5250,Dog,18
0,14,2020,Lorelei,3280,Cat,14
0,1,2019,West Sheffield Industrial,4600,Cat,1
0,6,2020,Hodgson,5620,Cat,6
0,27,2019,Westbrook Estates,5540,Cat,27
79,0,2019,Hawks Ridge,4473,Dog,79
10,0,2019,Mill Woods Town Centre,6520,Dog,10
168,0,2019,Beaumaris,3040,Dog,168
0,75,2019,Bellevue,2060,Cat,75
257,0,2019,Newton,2560,Dog,257
40,0,2020,Canora,4090,Dog,40
1,0,2019,Calgary Trail North,5110,Dog,1
46,0,2020,Kirkness,2430,Dog,46
2,0,2018,Gold Bar,6270,Dog,2
25,0,2020,Westridge,4610,Dog,25
252,0,2019,Gold Bar,6270,Dog,252
118,0,2020,Chappelle Area,5462,Dog,118
70,0,2020,Sakaw,6670,Dog,70
27,0,2020,Garneau,5200,Dog,27
0,67,2019,Canon Ridge,2120,Cat,67
271,0,2019,Ambleside,5505,Dog,271
0,24,2020,Riverdale,1210,Cat,24
66,0,2020,Holyrood,6310,Dog,66
23,0,2019,Stillwater,4468,Dog,23
0,141,2019,Queen Alexandra,5330,Cat,141
157,0,2019,Belgravia,5040,Dog,157
111,0,2020,Kiniski Gardens,6370,Dog,111
1,0,2017,Glenridding Heights,5578,Dog,1
0,132,2019,Evansdale,2260,Cat,132
121,0,2019,Tipaskan,6750,Dog,121
130,0,2019,Glenridding Heights,5578,Dog,130
0,31,2019,Webber Greens,4740,Cat,31
0,45,2019,Breckenridge Greens,4700,Cat,45
11,0,2020,Ebbers,2251,Dog,11
0,195,2019,Ormsby Place,4380,Cat,195
0,83,2019,Bulyea Heights,5100,Cat,83
72,0,2019,Paisley,5469,Dog,72
0,168,2019,Ritchie,6610,Cat,168
0,73,2019,Westwood,1250,Cat,73
4,0,2018,Killarney,2420,Dog,4
0,2,2020,Prince Charles,3350,Cat,2
28,0,2020,Fulton Place,6240,Dog,28
0,23,2020,Callingwood South,4080,Cat,23
137,0,2019,Sweet Grass,5490,Dog,137
1,0,2018,Sherbrooke,3410,Dog,1
14,0,2020,Terra Losa,4540,Dog,14
269,0,2019,Kensington,3250,Dog,269
3,0,2020,West Sheffield Industrial,4600,Dog,3
0,79,2019,Haddow,5610,Cat,79
0,13,2020,Matt Berry,2500,Cat,13
0,32,2019,Donsdale,4120,Cat,32
0,118,2019,Griesbach,3111,Cat,118
0,15,2020,Cromdale,1070,Cat,15
179,0,2019,Blackmud Creek,5453,Dog,179
0,18,2020,Gold Bar,6270,Cat,18
0,68,2019,Parkallen,5310,Cat,68
0,8,2020,Trumpeter Area,4471,Cat,8
0,6,2020,Pembina,3340,Cat,6
0,38,2019,Hodgson,5620,Cat,38
0,117,2019,Larkspur,6390,Cat,117
15,0,2020,McQueen,3300,Dog,15
31,0,2020,Hairsine,2320,Dog,31
0,25,2020,Belgravia,5040,Cat,25
50,0,2020,Glenridding Heights,5578,Dog,50
423,0,2019,Cumberland,3150,Dog,423
0,1,2019,Coronet Industrial,6100,Cat,1
0,49,2019,Laurel,6444,Cat,49
0,16,2020,Ermineskin,5180,Cat,16
69,0,2020,Ritchie,6610,Dog,69
669,0,2019,The Hamptons,4461,Dog,669
22,0,2020,Callingwood North,4070,Dog,22
1,0,2018,South Terwillegar,5642,Dog,1
0,31,2020,Meadowlark Park,4310,Cat,31
5,0,2019,Cashman,5466,Dog,5
0,163,2019,Parkdale,1160,Cat,163
1,0,2020,McNamara Industrial,4300,Dog,1
0,57,2019,Michaels Park,6480,Cat,57
28,0,2020,Queen Alexandra,5330,Dog,28
0,8,2019,Stewart Greens,4486,Cat,8
0,79,2019,Sweet Grass,5490,Cat,79
0,112,2019,Rosslyn,3390,Cat,112
287,0,2019,Capilano,6061,Dog,287
40,0,2019,Quesnell Heights,4420,Dog,40
110,0,2019,Michaels Park,6480,Dog,110
0,9,2020,Ekota,6200,Cat,9
1,0,2016,Callingwood North,4070,Dog,1
1,0,2018,North Glenora,3310,Dog,1
1,0,2019,Windermere Area,5575,Dog,1
45,0,2020,Crestwood,3140,Dog,45
0,18,2019,Blue Quill Estates,5070,Cat,18
23,0,2019,Stewart Greens,4486,Dog,23
0,10,2019,Kinokamau Plains Area,4475,Cat,10
282,0,2019,Parkview,3330,Dog,282
23,0,2019,The Uplands,4464,Dog,23
27,0,2020,Duggan,5160,Dog,27
1,0,2018,Chappelle Area,5462,Dog,1
4,0,2018,Cumberland,3150,Dog,4
0,42,2020,La Perle,4240,Cat,42
0,1,2018,Baturyn,3030,Cat,1
0,26,2020,Ambleside,5505,Cat,26
12,0,2020,Summerlea,4520,Dog,12
0,123,2019,Kenilworth,6350,Cat,123
0,56,2020,South Terwillegar,5642,Cat,56
203,0,2019,Sherbrooke,3410,Dog,203
2,0,2018,Minchau,6530,Dog,2
0,8,2020,High Park,4200,Cat,8
38,0,2020,Grovenor,3210,Dog,38
0,19,2020,Kildare,2400,Cat,19
10,0,2020,Desrochers Area,5463,Dog,10
74,0,2020,Haddow,5610,Dog,74
0,134,2019,Glenwood,4180,Cat,134
28,0,2020,Breckenridge Greens,4700,Dog,28
258,0,2019,Carlton,3470,Dog,258
132,0,2019,Lee Ridge,6400,Dog,132
0,11,2020,Ramsay Heights,5340,Cat,11
34,0,2020,Meadowlark Park,4310,Dog,34
107,0,2019,Potter Greens,4710,Dog,107
0,60,2019,Patricia Heights,4390,Cat,60
404,0,2019,Lymburn,4270,Dog,404
0,93,2019,Sakaw,6670,Cat,93
0,15,2020,Rio Terrace,4430,Cat,15
502,0,2019,Rutherford,5454,Dog,502
201,0,2019,Ozerna,2600,Dog,201
30,0,2020,Woodcroft,3450,Dog,30
14,0,2020,Skyrattler,5460,Dog,14
0,37,2020,Windermere,5570,Cat,37
1,0,2019,Stone Industrial,4510,Dog,1
0,84,2019,Ozerna,2600,Cat,84
0,11,2020,Richfield,6600,Cat,11
0,10,2020,Hudson,3480,Cat,10
0,89,2019,Glengarry,2290,Cat,89
43,0,2020,Avonmore,6020,Dog,43
4,0,2019,Huff Bremner Estate Industrial,3230,Dog,4
0,38,2019,Westridge,4610,Cat,38
95,0,2019,Granville,4551,Dog,95
0,107,2019,Hillview,6300,Cat,107
23,0,2020,Newton,2560,Dog,23
0,34,2019,Trumpeter Area,4471,Cat,34
135,0,2019,Ermineskin,5180,Dog,135
0,215,2019,Lymburn,4270,Cat,215
158,0,2019,Pollard Meadows,6580,Dog,158
8,0,2020,Rural North East South Sturgeon,2690,Dog,8
0,44,2019,Wedgewood Heights,4570,Cat,44
1,0,2018,Charlesworth,6661,Dog,1
0,2,2018,Forest Heights,6230,Cat,2
0,17,2020,Royal Gardens,5430,Cat,17
0,28,2020,Parkallen,5310,Cat,28
116,0,2019,Terrace Heights,6730,Dog,116
0,8,2020,Leger,5630,Cat,8
216,0,2019,Mayfield,4290,Dog,216
189,0,2019,Ramsay Heights,5340,Dog,189
36,0,2020,Homesteader,2350,Dog,36
94,0,2019,Wedgewood Heights,4570,Dog,94
56,0,2020,Ormsby Place,4380,Dog,56
0,1,2018,Dunluce,3180,Cat,1
0,20,2020,Schonsee,2700,Cat,20
0,173,2019,Bonnie Doon,6040,Cat,173
0,75,2019,Menisa,6450,Cat,75
0,18,2020,Beverly Heights,2100,Cat,18
0,18,2020,Tweddle Place,6760,Cat,18
0,1,2019,Edmiston Industrial,4130,Cat,1
0,5,2020,Virginia Park,1240,Cat,5
44,0,2019,Riverview Area,4463,Dog,44
2,0,2018,Callingwood North,4070,Dog,2
2,0,2018,Wild Rose,6790,Dog,2
0,5,2020,Ebbers,2251,Cat,5
0,107,2019,Hairsine,2320,Cat,107
76,0,2019,Grandview Heights,5210,Dog,76
1,0,2018,Maple Ridge,6410,Dog,1
0,95,2019,Parkview,3330,Cat,95
0,22,2019,Virginia Park,1240,Cat,22
0,117,2019,Fraser,2280,Cat,117
0,7,2020,Laurel,6444,Cat,7
255,0,2019,Beacon Heights,2040,Dog,255
1,0,2018,Brookside,5090,Dog,1
2,0,2020,Edmonton Energy And Technology Park,2681,Dog,2
0,27,2020,Terwillegar Towne,5640,Cat,27
0,11,2019,Rural North East South Sturgeon,2690,Cat,11
0,183,2019,Belmont,2070,Cat,183
0,66,2019,Prince Charles,3350,Cat,66
1,0,2018,Brander Gardens,5080,Dog,1
24,0,2020,West Meadowlark Park,4590,Dog,24
0,67,2019,Terrace Heights,6730,Cat,67
0,2,2018,Cumberland,3150,Cat,2
30,0,2020,McLeod,2530,Dog,30
61,0,2020,Belmont,2070,Dog,61
329,0,2019,Jamieson Place,4220,Dog,329
0,30,2020,Montrose,2550,Cat,30
1,0,2017,Windermere,5570,Dog,1
0,20,2020,Pollard Meadows,6580,Cat,20
0,290,2019,Westmount,3440,Cat,290
185,0,2019,Killarney,2420,Dog,185
0,1,2018,Skyrattler,5460,Cat,1
137,0,2019,Rapperswill,3370,Dog,137
0,85,2019,McKernan,5290,Cat,85
165,0,2019,Blue Quill,5060,Dog,165
0,17,2020,Central McDougall,1030,Cat,17
0,4,2020,Grandview Heights,5210,Cat,4
143,0,2019,Woodcroft,3450,Dog,143
146,0,2019,Elmwood,4140,Dog,146
0,92,2019,Belgravia,5040,Cat,92
68,0,2020,Calder,3070,Dog,68
2,0,2018,Evansdale,2260,Dog,2
0,24,2020,Canora,4090,Cat,24
0,44,2019,Elsinore,3190,Cat,44
30,0,2020,Belmead,4040,Dog,30
286,0,2019,Highlands,2330,Dog,286
143,0,2019,Trumpeter Area,4471,Dog,143
0,21,2020,Allard,5458,Cat,21
0,47,2020,Alberta Avenue,1010,Cat,47
0,175,2019,Terwillegar Towne,5640,Cat,175
0,100,2020,Oliver,1150,Cat,100
71,0,2020,Alberta Avenue,1010,Dog,71
0,148,2019,Beverly Heights,2100,Cat,148
0,53,2019,McQueen,3300,Cat,53
75,0,2020,Silver Berry,6442,Dog,75
0,13,2020,Kameyosek,6340,Cat,13
52,0,2019,Armstrong Industrial,4030,Dog,52
5,0,2020,Pembina,3340,Dog,5
0,75,2019,Malmo Plains,5280,Cat,75
0,14,2020,Elmwood,4140,Cat,14
0,72,2019,Blue Quill,5060,Cat,72
316,0,2019,Crawford Plains,6140,Dog,316
0,1,2018,Summerside,6213,Cat,1
0,158,2019,Hollick-Kenyon,2340,Cat,158
22,0,2020,Falconer Heights,5190,Dog,22
0,14,2020,Mayliewan,2511,Cat,14
1,0,2019,Rural West Big Lake,4470,Dog,1
0,50,2019,Abbottsfield,2010,Cat,50
0,18,2020,Glenwood,4180,Cat,18
66,0,2020,Highlands,2330,Dog,66
75,0,2019,Ogilvie Ridge,5300,Dog,75
0,132,2019,Delwood,2230,Cat,132
1,0,2018,Greenfield,5220,Dog,1
325,0,2019,Kilkenny,2410,Dog,325
0,141,2019,Newton,2560,Cat,141
0,1,2018,Matt Berry,2500,Cat,1
26,0,2020,Rio Terrace,4430,Dog,26
0,20,2020,Fulton Place,6240,Cat,20
0,1,2016,Leger,5630,Cat,1
0,31,2020,Dovercourt,3170,Cat,31
1,0,2018,Ramsay Heights,5340,Dog,1
0,12,2020,Westview Village,4620,Cat,12
40,0,2020,Lee Ridge,6400,Dog,40
0,16,2020,Spruce Avenue,1230,Cat,16
39,0,2020,Allendale,5010,Dog,39
1,0,2018,Avonmore,6020,Dog,1
0,1,2018,Beverly Heights,2100,Cat,1
63,0,2020,McConachie Area,2521,Dog,63
0,12,2020,Oxford,3320,Cat,12
22,0,2020,Malmo Plains,5280,Dog,22
0,93,2019,Capilano,6061,Cat,93
0,63,2020,Glastonbury,4720,Cat,63
36,0,2020,Athlone,3010,Dog,36
13,0,2020,Aspen Gardens,5020,Dog,13
62,0,2020,Griesbach,3111,Dog,62
3,0,2019,Gorman,2311,Dog,3
0,26,2020,Casselman,2130,Cat,26
6,0,2020,Rideau Park,5360,Dog,6
26,0,2020,Carlisle,3090,Dog,26
0,37,2020,Allendale,5010,Cat,37
53,0,2020,Allard,5458,Dog,53
41,0,2020,Lago Lindo,2450,Dog,41
0,17,2020,Gariepy,4160,Cat,17
0,249,2019,Queen Mary Park,1180,Cat,249
54,0,2020,Meyokumin,6460,Dog,54
132,0,2019,Delton,1080,Dog,132
0,160,2019,Hazeldean,6290,Cat,160
0,10,2020,Mactaggart,5477,Cat,10
2,0,2018,Twin Brooks,5511,Dog,2
0,81,2019,Delton,1080,Cat,81
0,26,2020,Bannerman,2030,Cat,26
1,0,2019,University of Alberta,5520,Dog,1
0,1,2016,Rosslyn,3390,Cat,1
268,0,2019,Inglewood,3240,Dog,268
0,1,2018,Downtown,1090,Cat,1
43,0,2020,Edgemont,4462,Dog,43
31,0,2020,Queen Mary Park,1180,Dog,31
2,0,2018,Highlands,2330,Dog,2
274,0,2019,Walker,6662,Dog,274
58,0,2020,Rhatigan Ridge,5350,Dog,58
1,0,2016,Argyll,6010,Dog,1
0,19,2020,Laurier Heights,3270,Cat,19
41,0,2020,Kensington,3250,Dog,41
57,0,2020,Inglewood,3240,Dog,57
0,28,2020,Greenfield,5220,Cat,28
251,0,2019,Wellington,3430,Dog,251
2,0,2016,Ormsby Place,4380,Dog,2
193,0,2019,Edgemont,4462,Dog,193
0,1,2016,Summerside,6213,Cat,1
0,130,2019,Strathearn,6710,Cat,130
247,0,2019,Charlesworth,6661,Dog,247
107,0,2019,Garneau,5200,Dog,107
253,0,2019,MacEwan,5452,Dog,253
0,94,2019,Meyonohk,6470,Cat,94
0,70,2019,Clareview Town Centre,2145,Cat,70
131,0,2019,Cameron Heights,4466,Dog,131
84,0,2019,Summerlea,4520,Dog,84
0,1,2018,Boyle Street,1020,Cat,1
0,17,2020,Idylwylde,6320,Cat,17
1,0,2018,Strathcona,5480,Dog,1
23,0,2020,Michaels Park,6480,Dog,23
1,0,2018,West Jasper Place,4580,Dog,1
0,31,2019,Albany,3460,Cat,31
46,0,2020,Forest Heights,6230,Dog,46
266,0,2019,Holyrood,6310,Dog,266
0,15,2020,Canossa,3080,Cat,15
94,0,2020,Capilano,6061,Dog,94
0,88,2019,Daly Grove,6150,Cat,88
144,0,2019,Rio Terrace,4430,Dog,144
0,88,2019,Miller,2541,Cat,88
0,1,2020,Stewart Greens,4486,Cat,1
197,0,2019,Homesteader,2350,Dog,197
347,0,2019,Beverly Heights,2100,Dog,347
0,6,2020,Cloverdale,6070,Cat,6
2,0,2020,Mill Creek Ravine North,6491,Dog,2
84,0,2020,Lymburn,4270,Dog,84
188,0,2019,Allendale,5010,Dog,188
0,115,2019,Chappelle Area,5462,Cat,115
1,0,2018,McConachie Area,2521,Dog,1
0,21,2020,Canon Ridge,2120,Cat,21
0,382,2019,Alberta Avenue,1010,Cat,382
0,116,2019,Ermineskin,5180,Cat,116
2,0,2019,Alberta Park Industrial,4010,Dog,2
0,131,2019,Carlisle,3090,Cat,131
0,36,2020,Griesbach,3111,Cat,36
2,0,2018,Glengarry,2290,Dog,2
156,0,2019,Riverdale,1210,Dog,156
5,0,2019,Maple Ridge Industrial,6420,Dog,5
220,0,2019,Rundle Heights,2660,Dog,220
0,61,2019,Skyrattler,5460,Cat,61
0,1,2018,Glengarry,2290,Cat,1
0,1,2018,Alberta Avenue,1010,Cat,1
24,0,2020,Elmwood,4140,Dog,24
57,0,2020,Walker,6662,Dog,57
5,0,2019,Winterburn Industrial Area West,4670,Dog,5
0,29,2020,Hollick-Kenyon,2340,Cat,29
43,0,2020,Jackson Heights,6330,Dog,43
0,15,2020,York,2720,Cat,15
0,16,2020,Thorncliff,4560,Cat,16
0,9,2020,McCauley,1140,Cat,9
0,4,2020,Rural North East South Sturgeon,2690,Cat,4
0,2,2018,Potter Greens,4710,Cat,2
0,58,2019,Cromdale,1070,Cat,58
1,0,2019,Ellerslie Industrial,6214,Dog,1
169,0,2019,Casselman,2130,Dog,169
0,17,2020,Steinhauer,5470,Cat,17
1,0,2018,Calder,3070,Dog,1
5,0,2020,Decoteau,6663,Dog,5
0,1,2018,Hollick-Kenyon,2340,Cat,1
0,1,2019,Edmonton Energy And Technology Park,2681,Cat,1
4,0,2020,Riverview Area,4463,Dog,4
18,0,2020,Cy Becker,2611,Dog,18
0,1,2018,Montrose,2550,Cat,1
0,14,2020,Bearspaw,5030,Cat,14
57,0,2020,Oleskiw,4360,Dog,57
1,0,2018,Forest Heights,6230,Dog,1
207,0,2019,Daly Grove,6150,Dog,207
0,1,2019,Winterburn Industrial Area East,4650,Cat,1
0,1,2013,Michaels Park,6480,Cat,1
63,0,2019,Abbottsfield,2010,Dog,63
1,0,2018,Rundle Heights,2660,Dog,1
0,1,2019,Calgary Trail North,5110,Cat,1
0,2,2019,Decoteau,6663,Cat,2
31,0,2020,Miller,2541,Dog,31
0,195,2019,Baturyn,3030,Cat,195
8,0,2020,Mistatim Industrial,4320,Dog,8
54,0,2020,Pleasantview,5320,Dog,54
38,0,2019,Desrochers Area,5463,Dog,38
0,23,2019,Paisley,5469,Cat,23
0,35,2020,Glenora,3200,Cat,35
4,0,2020,Stewart Greens,4486,Dog,4
19,0,2019,Coronet Industrial,6100,Dog,19
0,27,2020,Evergreen,2270,Cat,27
0,6,2020,Westbrook Estates,5540,Cat,6
0,148,2019,Crawford Plains,6140,Cat,148
0,5,2019,Kinglet Gardens,4477,Cat,5
0,46,2020,Ritchie,6610,Cat,46
41,0,2020,Ozerna,2600,Dog,41
0,2,2019,Winterburn Industrial Area West,4670,Cat,2
1,0,2018,Belmont,2070,Dog,1
0,57,2019,Rio Terrace,4430,Cat,57
46,0,2020,Gariepy,4160,Dog,46
40,0,2020,Trumpeter Area,4471,Dog,40
32,0,2020,Royal Gardens,5430,Dog,32
16,0,2020,Dechene,4110,Dog,16
178,0,2019,Callaghan,5457,Dog,178
0,21,2020,Balwin,2020,Cat,21
0,61,2019,Brander Gardens,5080,Cat,61
0,2,2018,Westmount,3440,Cat,2
351,0,2019,Lago Lindo,2450,Dog,351
0,2,2018,Patricia Heights,4390,Cat,2
17,0,2020,Westbrook Estates,5540,Dog,17
0,29,2020,Maple Ridge,6410,Cat,29
7,0,2019,Winterburn Industrial Area East,4650,Dog,7
13,0,2020,Blackburne,5590,Dog,13
0,43,2020,Klarvatten,2440,Cat,43
121,0,2019,Overlanders,2590,Dog,121
0,48,2020,Rutherford,5454,Cat,48
131,0,2019,Strathearn,6710,Dog,131
0,38,2019,Lansdowne,5260,Cat,38
0,76,2019,High Park,4200,Cat,76
0,20,2020,Twin Brooks,5511,Cat,20
224,0,2019,Mayliewan,2511,Dog,224
0,21,2020,Rosslyn,3390,Cat,21
82,0,2020,Dunluce,3180,Dog,82
112,0,2019,Elmwood Park,1130,Dog,112
2,0,2018,Webber Greens,4740,Dog,2
0,86,2019,McLeod,2530,Cat,86
0,114,2019,Gold Bar,6270,Cat,114
80,0,2019,Lansdowne,5260,Dog,80
0,15,2020,Delton,1080,Cat,15
0,28,2020,Lago Lindo,2450,Cat,28
1,0,2020,Calgary Trail North,5110,Dog,1
3,0,2018,Lago Lindo,2450,Dog,3
0,34,2020,Larkspur,6390,Cat,34
79,0,2019,Cy Becker,2611,Dog,79
0,30,2020,Mayfield,4290,Cat,30
0,1,2019,Carleton Square Industrial,4100,Cat,1
131,0,2019,Richfield,6600,Dog,131
43,0,2020,Northmount,2580,Dog,43
0,96,2019,Carlton,3470,Cat,96
106,0,2019,Canon Ridge,2120,Dog,106
35,0,2020,Ekota,6200,Dog,35
173,0,2019,Miller,2541,Dog,173
24,0,2020,McKernan,5290,Dog,24
27,0,2020,Idylwylde,6320,Dog,27
0,110,2019,Rundle Heights,2660,Cat,110
158,0,2019,The Orchards At Ellerslie,6216,Dog,158
27,0,2020,Carter Crest,5130,Dog,27
0,19,2020,Woodcroft,3450,Cat,19
0,86,2019,West Jasper Place,4580,Cat,86
0,257,2019,Summerside,6213,Cat,257
0,1,2018,Schonsee,2700,Cat,1
0,4,2020,Stillwater,4468,Cat,4
17,0,2020,Tawa,6720,Dog,17
44,0,2020,Fraser,2280,Dog,44
0,47,2019,Terra Losa,4540,Cat,47
7,0,2020,Blue Quill Estates,5070,Dog,7
221,0,2019,Jackson Heights,6330,Dog,221
0,48,2019,Prince Rupert,1170,Cat,48
50,0,2020,Pollard Meadows,6580,Dog,50
0,25,2020,Westwood,1250,Cat,25
0,4,2020,Falconer Heights,5190,Cat,4
1,0,2018,Aldergrove,4020,Dog,1
79,0,2020,Westmount,3440,Dog,79
28,0,2019,Pembina,3340,Dog,28
0,77,2019,Keheewin,5250,Cat,77
128,0,2019,Mactaggart,5477,Dog,128
0,35,2020,Holyrood,6310,Cat,35
0,80,2019,Canora,4090,Cat,80
0,1,2018,Ramsay Heights,5340,Cat,1
0,2,2018,McQueen,3300,Cat,2
24,0,2019,Cavanagh,5467,Dog,24
0,9,2020,Rosenthal,4750,Cat,9
2,0,2016,Belmont,2070,Dog,2
0,101,2019,Greenfield,5220,Cat,101
0,2,2018,Pollard Meadows,6580,Cat,2
0,16,2020,Glenridding Heights,5578,Cat,16
0,17,2019,Keswick Area,5576,Cat,17
0,101,2019,Forest Heights,6230,Cat,101
0,1,2018,Tamarack,6443,Cat,1
15,0,2020,Leger,5630,Dog,15
1,0,2018,Glenora,3200,Dog,1
81,0,2019,Westbrook Estates,5540,Dog,81
0,75,2019,Jackson Heights,6330,Cat,75
61,0,2020,Glenora,3200,Dog,61
1,0,2019,Strathcona Junction,5151,Dog,1
0,1,2018,Canora,4090,Cat,1
40,0,2020,Lynnwood,4280,Dog,40
1,0,2020,Hagmann Estate Industrial,3220,Dog,1
86,0,2020,Cumberland,3150,Dog,86
1,0,2019,Papaschase Industrial,6560,Dog,1
0,46,2019,Sherwood,4500,Cat,46
0,258,2019,Ottewell,6550,Cat,258
119,0,2019,Chambery,3120,Dog,119
2,0,2019,University of Alberta Farm,5530,Dog,2
337,0,2019,McConachie Area,2521,Dog,337
0,10,2020,Malmo Plains,5280,Cat,10
4,0,2020,Weir Industrial,6780,Dog,4
1,0,2018,Fraser,2280,Dog,1
0,165,2019,Glastonbury,4720,Cat,165
0,116,2019,Twin Brooks,5511,Cat,116
1,0,2018,Carlisle,3090,Dog,1
194,0,2019,Queen Mary Park,1180,Dog,194
0,1,2019,Yellowhead Corridor East,1270,Cat,1
0,171,2019,Empire Park,5170,Cat,171
0,93,2019,Grovenor,3210,Cat,93
206,0,2019,Menisa,6450,Dog,206
0,150,2019,Cumberland,3150,Cat,150
40,0,2020,Brintnell,2110,Dog,40
0,3,2019,Strathcona Industrial Park,6700,Cat,3
36,0,2020,Suder Greens,4730,Dog,36
0,13,2020,Lee Ridge,6400,Cat,13
0,4,2019,Riverview Area,4463,Cat,4
1,0,2018,Terwillegar Towne,5640,Dog,1
200,0,2019,Weinlos,6770,Dog,200
0,124,2019,Silver Berry,6442,Cat,124
0,91,2019,Beaumaris,3040,Cat,91
205,0,2019,Fulton Place,6240,Dog,205
237,0,2019,Belmead,4040,Dog,237
0,296,2019,Strathcona,5480,Cat,296
0,87,2019,McCauley,1140,Cat,87
66,0,2019,Tawa,6720,Dog,66
0,59,2019,Lendrum Place,5270,Cat,59
2,0,2020,Southeast Industrial,6690,Dog,2
1,0,2020,Edmonton South East,8886,Dog,1
0,98,2019,Belmead,4040,Cat,98
51,0,2020,Starling,4474,Dog,51
0,10,2019,Pembina,3340,Cat,10
0,40,2019,Tawa,6720,Cat,40
37,0,2020,Callaghan,5457,Dog,37
108,0,2019,Maple,6441,Dog,108
20,0,2020,Donsdale,4120,Dog,20
42,0,2020,Parkdale,1160,Dog,42
1,0,2018,Schonsee,2700,Dog,1
36,0,2020,Killarney,2420,Dog,36
3,0,2019,Clover Bar Area,2160,Dog,3
57,0,2020,Montrose,2550,Dog,57
0,10,2020,Edgemont,4462,Cat,10
0,30,2020,Kernohan,2390,Cat,30
298,0,2019,Aldergrove,4020,Dog,298
0,13,2020,Killarney,2420,Cat,13
76,0,2020,Strathcona,5480,Dog,76
1,0,2018,Weinlos,6770,Dog,1
29,0,2020,Granville,4551,Dog,29
0,11,2020,Belle Rive,2050,Cat,11
105,0,2019,Starling,4474,Dog,105
0,63,2019,Allard,5458,Cat,63
31,0,2020,Beaumaris,3040,Dog,31
0,7,2019,Kennedale Industrial,2380,Cat,7
16,0,2020,Rossdale,1220,Dog,16
15,0,2019,Edmonton South West,8888,Dog,15
0,1,2020,Glenridding Ravine,5579,Cat,1
1,0,2019,Place LaRue,4400,Dog,1
3,0,2018,Haddow,5610,Dog,3
46,0,2020,Hazeldean,6290,Dog,46
1,0,2018,Lorelei,3280,Dog,1
9,0,2019,Edmonton Energy And Technology Park,2681,Dog,9
0,62,2019,Matt Berry,2500,Cat,62
1,0,2019,Carleton Square Industrial,4100,Dog,1
1,0,2018,Canon Ridge,2120,Dog,1
0,31,2020,Menisa,6450,Cat,31
43,0,2020,Cameron Heights,4466,Dog,43
36,0,2020,Richfield,6600,Dog,36
103,0,2019,Lendrum Place,5270,Dog,103
0,34,2019,Henderson Estates,5230,Cat,34
0,13,2020,Sweet Grass,5490,Cat,13
0,112,2019,MacEwan,5452,Cat,112
69,0,2019,Cloverdale,6070,Dog,69
0,94,2019,Greenview,6280,Cat,94
90,0,2019,Sherwood,4500,Dog,90
0,34,2020,Ormsby Place,4380,Cat,34
0,37,2019,Falconer Heights,5190,Cat,37
0,10,2020,Rossdale,1220,Cat,10
252,0,2019,Glenwood,4180,Dog,252
269,0,2019,Delwood,2230,Dog,269
20,0,2020,McCauley,1140,Dog,20
0,1,2019,Hagmann Estate Industrial,3220,Cat,1
0,1,2020,Cavanagh,5467,Cat,1
0,103,2019,Overlanders,2590,Cat,103
15,0,2020,Cromdale,1070,Dog,15
0,33,2020,Capilano,6061,Cat,33
0,12,2020,Elsinore,3190,Cat,12
0,12,2020,Terra Losa,4540,Cat,12
218,0,2019,Carlisle,3090,Dog,218
0,9,2020,Aspen Gardens,5020,Cat,9
34,0,2020,Westview Village,4620,Dog,34
1,0,2019,Rampart Industrial,3360,Dog,1
6,0,2019,Yellowhead Corridor East,1270,Dog,6
49,0,2020,Belle Rive,2050,Dog,49
0,5,2020,Breckenridge Greens,4700,Cat,5
0,5,2020,Elmwood Park,1130,Cat,5
0,1,2018,Lago Lindo,2450,Cat,1
0,2,2018,Ormsby Place,4380,Cat,2
264,0,2019,Greenfield,5220,Dog,264
0,51,2019,Mayliewan,2511,Cat,51
0,1,2020,Kinokamau Plains Area,4475,Cat,1
843,0,2019,Summerside,6213,Dog,843
0,62,2019,Crestwood,3140,Cat,62
32,0,2020,Riverdale,1210,Dog,32
0,42,2019,Rhatigan Ridge,5350,Cat,42
0,27,2020,Calder,3070,Cat,27
71,0,2020,Oliver,1150,Dog,71
0,101,2019,Thorncliff,4560,Cat,101
57,0,2020,Greenfield,5220,Dog,57
127,0,2019,Westridge,4610,Dog,127
66,0,2020,Delwood,2230,Dog,66
0,41,2019,Tipaskan,6750,Cat,41
0,25,2020,McConachie Area,2521,Cat,25
0,24,2020,Weinlos,6770,Cat,24
0,23,2020,Rundle Heights,2660,Cat,23
0,101,2019,Sherbrooke,3410,Cat,101
145,0,2019,Tamarack,6443,Dog,145
308,0,2019,Wild Rose,6790,Dog,308
396,0,2019,Terwillegar Towne,5640,Dog,396
140,0,2019,McCauley,1140,Dog,140
0,1,2019,Huff Bremner Estate Industrial,3230,Cat,1
0,124,2019,Caernarvon,3060,Cat,124
0,1,2020,Clover Bar Area,2160,Cat,1
0,10,2020,Crestwood,3140,Cat,10
0,57,2019,Ekota,6200,Cat,57
235,0,2019,Kernohan,2390,Dog,235
21,0,2020,Sifton Park,2710,Dog,21
1,0,2020,Maple Ridge Industrial,6420,Dog,1
21,0,2020,Hudson,3480,Dog,21
0,8,2019,Heritage Valley Town Centre Area,5464,Cat,8
0,38,2019,Blackburne,5590,Cat,38
69,0,2019,Windsor Park,5580,Dog,69
26,0,2020,Sweet Grass,5490,Dog,26
1,0,2019,Norwester Industrial,4350,Dog,1
0,55,2019,The Orchards At Ellerslie,6216,Cat,55
1,0,2018,Clareview Town Centre,2145,Dog,1
240,0,2019,Parkdale,1160,Dog,240
0,151,2019,Holyrood,6310,Cat,151
36,0,2020,Matt Berry,2500,Dog,36
0,1,2020,Wedgewood Heights,4570,Cat,1
1,0,2016,Strathcona,5480,Dog,1
0,1,2020,Riverview Area,4463,Cat,1
1,0,2018,Brintnell,2110,Dog,1
0,26,2020,Walker,6662,Cat,26
0,28,2020,Pleasantview,5320,Cat,28
0,39,2020,Satoo,6680,Cat,39
0,2,2018,Bulyea Heights,5100,Cat,2
0,1,2020,The Uplands,4464,Cat,1
95,0,2019,Patricia Heights,4390,Dog,95
229,0,2019,Laurier Heights,3270,Dog,229
234,0,2019,Dovercourt,3170,Dog,234
0,32,2020,Kensington,3250,Cat,32
1,0,2019,Decoteau North,6664,Dog,1
191,0,2019,Bisset,6030,Dog,191
1,0,2020,River Valley Highlands,2640,Dog,1
0,60,2019,Jasper Park,4230,Cat,60
223,0,2019,Meadowlark Park,4310,Dog,223
23,0,2020,Boyle Street,1020,Dog,23
96,0,2019,Webber Greens,4740,Dog,96
0,2,2018,Dovercourt,3170,Cat,2
32,0,2019,Ebbers,2251,Dog,32
0,11,2020,Sherwood,4500,Cat,11
151,0,2019,Henderson Estates,5230,Dog,151
0,1,2018,Balwin,2020,Cat,1
0,110,2019,Kernohan,2390,Cat,110
0,1,2018,West Jasper Place,4580,Cat,1
0,44,2019,Cameron Heights,4466,Cat,44
5,0,2019,Aster,6445,Dog,5
0,20,2020,North Glenora,3310,Cat,20
0,19,2020,MacEwan,5452,Cat,19
1,0,2018,Queen Mary Park,1180,Dog,1
48,0,2020,Glenwood,4180,Dog,48
0,110,2019,Satoo,6680,Cat,110
0,2,2019,Norwester Industrial,4350,Cat,2
23,0,2019,Hays Ridge Area,5465,Dog,23
1,0,2018,Laurier Heights,3270,Dog,1
0,107,2019,Meadowlark Park,4310,Cat,107
0,28,2019,Mactaggart,5477,Cat,28
150,0,2019,Tweddle Place,6760,Dog,150
30,0,2020,Schonsee,2700,Dog,30
0,1,2019,Marquis,2671,Cat,1
0,155,2019,Garneau,5200,Cat,155
118,0,2020,Windermere,5570,Dog,118
0,1,2018,Glenwood,4180,Cat,1
175,0,2019,Evergreen,2270,Dog,175
0,1,2018,Crestwood,3140,Cat,1
164,0,2019,Brookside,5090,Dog,164
202,0,2019,Canossa,3080,Dog,202
52,0,2020,Menisa,6450,Dog,52
1,0,2018,Lee Ridge,6400,Dog,1
8,0,2020,Cavanagh,5467,Dog,8
34,0,2019,Richford,5451,Dog,34
0,171,2019,South Terwillegar,5642,Cat,171
165,0,2019,Queen Alexandra,5330,Dog,165
2,0,2017,Parkallen,5310,Dog,2
117,0,2019,Breckenridge Greens,4700,Dog,117
31,0,2020,Thorncliff,4560,Dog,31
0,17,2020,Terrace Heights,6730,Cat,17
0,176,2019,La Perle,4240,Cat,176
430,0,2019,South Terwillegar,5642,Dog,430
1,0,2018,Skyrattler,5460,Dog,1
0,29,2020,Oleskiw,4360,Cat,29
0,45,2020,Bonnie Doon,6040,Cat,45
0,51,2019,Cy Becker,2611,Cat,51
11,0,2020,Central McDougall,1030,Dog,11
356,0,2019,Hollick-Kenyon,2340,Dog,356
2,0,2019,Industrial Heights,2360,Dog,2
0,6,2020,Dechene,4110,Cat,6
0,17,2019,Chambery,3120,Cat,17
0,78,2019,Ellerslie,6211,Cat,78
0,2,2018,Belvedere,2080,Cat,2
24,0,2020,Oxford,3320,Dog,24
2,0,2016,McLeod,2530,Dog,2
1,0,2020,Kennedale Industrial,2380,Dog,1
0,46,2019,Hudson,3480,Cat,46
118,0,2019,Callingwood South,4080,Dog,118
73,0,2020,Laurier Heights,3270,Dog,73
200,0,2019,McLeod,2530,Dog,200
2,0,2019,Lewis Farms Industrial,4485,Dog,2
22,0,2020,Kameyosek,6340,Dog,22
1,0,2019,Mill Creek Ravine North,6491,Dog,1
0,1,2018,Belmont,2070,Cat,1
124,0,2019,Steinhauer,5470,Dog,124
0,55,2019,Brookside,5090,Cat,55
171,0,2019,Glengarry,2290,Dog,171
3,0,2016,Summerside,6213,Dog,3
0,102,2019,Mayfield,4290,Cat,102
0,111,2019,Dovercourt,3170,Cat,111
1,0,2019,Coronet Addition Industrial,6090,Dog,1
191,0,2019,Belle Rive,2050,Dog,191
1,0,2016,Montrose,2550,Dog,1
0,21,2020,Sherbrooke,3410,Cat,21
0,15,2020,Tipaskan,6750,Cat,15
33,0,2020,Sherbrooke,3410,Dog,33
10,0,2019,Kinglet Gardens,4477,Dog,10
1,0,2018,Rapperswill,3370,Dog,1
16,0,2020,Baranow,3020,Dog,16
13,0,2020,Cloverdale,6070,Dog,13
1,0,2018,Rideau Park,5360,Dog,1
0,12,2019,Desrochers Area,5463,Cat,12
0,1,2018,Rosslyn,3390,Cat,1
220,0,2019,Rhatigan Ridge,5350,Dog,220
1,0,2016,Jackson Heights,6330,Dog,1
0,44,2020,Garneau,5200,Cat,44
60,0,2019,Albany,3460,Dog,60
0,10,2020,Callaghan,5457,Cat,10
0,98,2019,West Meadowlark Park,4590,Cat,98
6,0,2020,Albany,3460,Dog,6
0,17,2020,Overlanders,2590,Cat,17
104,0,2019,Leger,5630,Dog,104
0,45,2019,Summerlea,4520,Cat,45
140,0,2019,West Meadowlark Park,4590,Dog,140
0,1,2019,Armstrong Industrial,4030,Cat,1
26,0,2020,Paisley,5469,Dog,26
0,16,2020,McKernan,5290,Cat,16
0,1,2019,Edmonton Research and Development Park,6190,Cat,1
276,0,2019,Silver Berry,6442,Dog,276
141,0,2019,Schonsee,2700,Dog,141
0,79,2019,Canossa,3080,Cat,79
4,0,2019,Weir Industrial,6780,Dog,4
0,9,2020,Keswick Area,5576,Cat,9
73,0,2019,Rossdale,1220,Dog,73
0,4,2020,CPR Irvine,6110,Cat,4
0,114,2019,Beacon Heights,2040,Cat,114
0,17,2020,Minchau,6530,Cat,17
215,0,2019,Satoo,6680,Dog,215
0,49,2019,Rosenthal,4750,Cat,49
0,4,2020,Cameron Heights,4466,Cat,4
160,0,2020,The Hamptons,4461,Dog,160
1,0,2019,West Sheffield Industrial,4600,Dog,1
0,229,2019,The Hamptons,4461,Cat,229
0,67,2019,Callingwood North,4070,Cat,67
0,92,2019,Fulton Place,6240,Cat,92
36,0,2020,Eastwood,1100,Dog,36
66,0,2019,Central McDougall,1030,Dog,66
0,27,2019,Granville,4551,Cat,27
0,32,2019,Starling,4474,Cat,32
261,0,2019,Forest Heights,6230,Dog,261
0,107,2019,Riverdale,1210,Cat,107
33,0,2020,Bearspaw,5030,Dog,33
32,0,2020,Strathearn,6710,Dog,32
0,3,2020,Cy Becker,2611,Cat,3
57,0,2020,Satoo,6680,Dog,57
1,0,2018,Windermere,5570,Dog,1
27,0,2020,Rosslyn,3390,Dog,27
2,0,2019,Edmonton South Central,8887,Dog,2
2,0,2018,Rosslyn,3390,Dog,2
19,0,2020,Steinhauer,5470,Dog,19
0,39,2020,Delwood,2230,Cat,39
1,0,2018,Parkallen,5310,Dog,1
0,79,2019,Oxford,3320,Cat,79
4,0,2020,Quesnell Heights,4420,Dog,4
